WEWWW
W   W
W W W
W   W
WWXWW
